
          # ############### # ############### ###
         # #               # #               #   #
         # # ####### ##### # # # ### ######### # #
         # # #       #   # # # # #   #         # #
         # # # ####### ### # # # # ### ######### #
         # # # #     #     #   # # #           # #
         # # # # ##### ####### # ### ########### #
         #   # # #     #     # #     #     #     #
         # ### # # ##### ### ####### # ### # ### #
         #   # # # #     #   #     # # # # # #   #
          ## # # # ### ### ### ### ### # # # ####
         #   # #   #   # #     # # #   # # # #   #
         # ### # ### ### ####### # # ### # # # # #
         # #   #     #         #   # #   # #   # #
         # # ######### ####### # ### ### # # ### #
         # #     #     #     # #   #   #   # #   #
         # ##### ### ### # ### ### # # ### ### # #
         # #   #   #   # #   #     # #   #     # #
         # # # ### ### ##### ###### #### ####### #
         # # # # #   #             #   # #     # #
         # # # # ### ####### ##### # # # # ##### #
         #   # # #   #       #X#     #   #   #   #
          #### # # ######### # ########### # # ##
         #   # # #         # #         #   # # # #
          ## # # ######### ########### # ### # # #
         #   # #     #     #     #   # # #   #   #
         # ### ##### # # ### # ### # # # # ##### #
         #   #       # # #   #     #   # #       #
         # # ##### ### # # ######## #### ########
         # #       #   # #         #   # #     # #
         # ######### # ########### ### # # ### # #
         #     # #   # #         # #   #   #   # #
          #### # # ##### # ####### # ####### ### #
         #   #   # #     #       # #       # #   #
         # # # ### # ########### # # ### # # ### #
         # #   #   #   #     #   # # # # # #   # #
         # ##### # ### # ##### ### # # # ##### # #
         #     # # #   #     # #   #   #     #   #
          #### # ### ####### # # ##### ##### ### #
         #O    #             #   #         #     #
          ##### ############# ### ######### #####
