..................................#####....
..................................#...#....
..................................#...#....
..................................#...#....
..............................#########....
..............................#...#........
..............................#...#........
..............................#...#........
..............................#...#........
..............................#...#........
..............................#...#........
..............................#...#........
..........................#########........
..........................#...#............
..........................#...#############
..........................#...............#
..........................#############...#
......................................#...#
..................................#########
..................................#...#....
#####...........###########.......#...#....
#...#...........#.........#.......#...#....
#...#...........#.........#.......#...#....
#...#...........#.........#.......#...#....
#############...#.........#.......#...#....
....#.......#...#.........#.......#...#....
....#.......#...#.........#...^########....
....#.......#...#.........#.......#........
....###########.#.........#########........
............#.#.#..........................
............#.#.#..........................
............#.#.#..........................
............#####..........................
..............#............................
..........#########........................
..........#...#...#........................
......#########...#........................
......#...#.......#........................
......#...#.......#........................
......#...#.......#........................
......#...#.......#........................
......#...#.......#........................
......#...#.......#############............
......#...#...................#............
..#########...................#............
..#...#.......................#............
..#...#...................#####............
..#...#....................................
..#####....................................
